{
  "id": "catacombs",
  "name": "The Catacombs",
  "music": "catacombs",
  "layout": [
    "########################################################################################################################",
    "#......................................................................................................................#",
    "#.........====.............====..........====..............====.............d......d...................................#",
    "#....................b.........k............g.......b..........................b.......................................#",
    "#.......n......b............s..........h................g........h.....................................................#",
    "#..................====........====................H............................F......................................#",
    "#............n...................................n.....C.............s.......g.........................................#",
    "#.............S..............C.........x..C...................C........................................................#",
    "#..P......c...n.....k........k..x.s...c........r......n........c....k.x.x.....r...c.x...........L.........B............#",
    "############################..##..####################################..##..############################################",
    "########################################################################################################################"
  ]
}
