{
  "id": "level2",
  "name": "The Gallows",
  "music": "catacombs",
  "layout": [
    "########################################################################################################################",
    "#......................................................................................................................#",
    "#.........====.............====..........====..............====........................................................#",
    "#.....................b..........k.................b...................................................................#",
    "#........n......b...........s...........h..............g...............................................................#",
    "#..................====........====.................====...............................................................#",
    "#............n..................................n.....C....C...........................................................#",
    "#..............S..............C..........x.C...........................................................................#",
    "#..P......c...n.....k........k....s...c........r......n........c....k.........r...c..............L..........E..........#",
    "############################xx##xx####################################xx##xx############################################",
    "########################################################################################################################"
  ]
}
