{
  "id": "main",
  "name": "The Depths",
  "music": "depths",
  "layout": [
    "#.......................################################################################################################",
    ".......................................................................................................................#",
    "..................................====............====..........====......====..........d..............................#",
    "......................................b..................g.........................b...................................#",
    ".............f.....b................f.................O.....s.................D........................................#",
    "...............................====.......................H.......................F....................................#",
    "...........................................................h.....C.............s.......g...............................#",
    ".........................S...............C.................................C...........................................#",
    "..P.....C...c.....c.........c.......k...c.........r........n.....c........k...........k...c.......L........B...........#",
    "############################xx####xx########################################xx####xx####xx##############################",
    "########################################################################################################################"
  ]
}
